111111111111111111111
1S0000100000000000001
101110111111101111101
100010000000101000001
111011111010101011101
100000001010001010001
101111101011111010111
101000001000000010001
101011111111111111101
101000000000000000101
101111111111111110101
100000000000000010101
111111111111111010101
100000000000001010001
101111111111101011101
101000000000101000101
101011111110101110101
100010000010100000101
111010111010111111101
10000000100000000000E
111111111111111111111